 ------------------------------------------------X
   ----------------------------------------------X
 X   ---------------------------------------------
 X X ---------------------------------------------
 XX- ---------------------------------------------
 X X X--------------------------------------------
   X    ------------------------------------------
XX XX X    ---------------------------------------
--X-- X XX ---------------------------------------
----- X X- ---------------------------------------
----- XX-- ---------------------------------------
----- X---       ---------------------------------
----- X--- XXXXX ---------------------------------
-      X--  ----   -------------------------------
- XXX X---- X---XX -------------------------------
  X-X X---- X----- -------------------------------
 X---X-----    ---  ------------------------------
 X------------ X--X X-----------------------------
 X------------ X-   X-----------------------------
 X------------   EXX------------------------------
X----------------X--------------------------------
--------------------------------------------------
--------------------------------------------------
--------------------------------------------------
--------------------------------------------------
--------------------------------------------------
--------------------------------------------------
--------------------------------------------------
--------------------------------------------------
--------------------------------------------------
--------------------------------------------------
--------------------------------------------------
--------------------------------------------------
--------------------------------------------------
--------------------------------------------------
--------------------------------------------------
--------------------------------------------------
--------------------------------------------------
--------------------------------------------------
--------------------------------------------------
--------------------------------------------------
--------------------------------------------------
--------------------------------------------------
--------------------------------------------------
--------------------------------------------------
--------------------------------------------------
--------------------------------------------------
--------------------------------------------------
--------------------------------------------------
X-------------------------------------------------
